0 0 0 0 0 0 0 0 0 6 0 0 0 0 0 0 6 0 0 0
9 6 0 0 0 0 0 0 0 0 0 0 6 0 0 0 0 0 0 0
0 6 0 0 0 0 0 0 0 0 0 0 0 0 0 0 0 0 0 0
0 0 0 0 0 0 0 0 6 0 0 0 6 0 0 0 0 0 0 0
0 0 0 0 0 0 0 0 0 8 0 0 0 0 0 0 0 0 0 0
0 0 6 0 0 0 0 0 0 0 0 0 0 0 0 6 0 0 0 0
0 9 0 6 0 0 0 0 0 0 0 0 0 0 0 0 0 0 0 0
0 0 0 0 0 0 0 0 0 0 0 0 0 0 0 0 0 6 9 0
0 0 0 0 0 6 0 6 0 0 0 0 0 0 0 0 6 0 0 0
0 0 0 0 0 0 0 9 0 0 0 0 0 0 6 0 0 0 0 0