0 0 0 0 0 0 0 0 0 6:2 0 0 0 0 0 0 6:3 0 0 0
9:1 6:1 0 0 0 0 0 0 0 0 0 0 6:1 0 0 0 0 0 0 0
0 6:2 0 0 0 0 0 0 0 0 0 0 0 0 0 0 0 0 0 0
0 0 0 0 0 0 0 0 6:2 0 0 0 6:0 0 0 0 0 0 0 0
0 0 0 0 0 0 0 0 0 8 0 0 0 0 0 0 0 0 0 0
0 0 6:2 0 0 0 0 0 0 0 0 0 0 0 0 6:0 0 0 0 0
0 9:1 0 6:1 0 0 0 0 0 0 0 0 0 0 0 0 0 0 0 0
0 0 0 0 0 0 0 0 0 0 0 0 0 0 0 0 0 6:3 9:3 0
0 0 0 0 0 6:3 0 6:0 0 0 0 0 0 0 0 0 6:0 0 0 0
0 0 0 0 0 0 0 9:3 0 0 0 0 0 0 6:3 0 0 0 0 0